Olivelle's Yati p. 47 on sa.mdhyaa
p 32: 3 views on aa"sramas


GṚHASTHA (SADĀŚIVA)
REAL = MENTAL
yajñavāṭa (sacr. groud) = kurukṣetraṃ (in the body, see 13.2 --> 12.12c) VEDIC, INTERNALIZATION
ālayaḥ = sattvāvāsa  : dwelling place is sattva, MORAL      
mahāvediḥ = pratyāhāra  : VEDIC, MENTAL PROCESS
kuśaprastara = saṃyamaḥ : VEDIC, YOGIC - - > MENTAL
vidhi = niyamavistāro : VEDIC - - > YOGIC, moral
vahni = dhyāna : sacr. fire is dhyāna, YOGIC
indhana/samidh = yoga: YOGIC 
dhūpa = tapas : YOGIC
pātranyāsa = śivajñāna : MENTAL
sthālīpāka (boiled rice offering) = śivātmaka?
śruva = lambaka (the uvula?) : INTERN, BODY 
adhvaryu = dhāraṇā: VEDIC - - > YOGIC 
ṛtvijaḥ = prāṇāyāmaś VEDIC - - > YOGIC
vayatāpana = tarkayuktaḥ savistāraḥ samādhiḥ YOGIC
yūpaḥ = brahmavidyā 
paśubandha = manonmana  
śraddhā = patnī viśālākṣī?  or the other way around?
saṃkalpa = padaṃ śāśvatam VEDIC - - > whatever
pañcendriyajayotpannaḥ puroḍāśaḥ =  'mṛtāśanaḥ VEDIC - - > YOGIC
mahāmantra = brahmanāda (=brahmabilasvara) 
prāyaścitta  = anilajaya  YOGIC
somapāna = parijñāna  
upākarma = caturyama? VEDIC - - > moral? 
jalasnānaṃ = itihāsa RITUAL - - > READING
ambara = purāṇa  CLOTHES - - > READING
snāna, ācamana = iḍāsuṣumnāsaṃvedye RITUAL - - > INTERN, YOGIC
atithi = saṃtoṣa  SMṚTI - - > MENTAL
dvija = dayā      SMṚṬI - - > MENTAL
brahmakūrca (penance) = guṇātīta  SMṚTI - - > MENTAL YOGIC
havirgandha = nirañjanaḥ          VEDIC - - > MENTAL YOGIC
brahmasūtra = trayas tattvaṃ      CLOTHES, RITUAL - - > PHILOSOPHY
muṇḍitaṃ śiraḥ - - > bodhanā SMṚTI - - > ?  
caturveda = nirvṛtyādi VEDIC - - > MENTAL?   
catuḥprakaraṇa = āsana
dakṣiṇām = abhayaṃ bhūte VEDIC - - > MORAL  

BRAHMACĀRIN (ŚIVA):






